[nivel]
origen=imagen/fondo.png
alto=32
ancho=32
mapa=.a.a.a.a.a.a.a.a.a.a.a.a.a.a.a.a.a.a.a.a.a
     #    %    %                              $
     $    &  % &          &     %&%&%&%&%&%&% #
     #  %&%  & %     &%&%&%     &             $
     $       %  &    %          % &%&%&%&%&%&%#
     #%&%&%&%& %     & %&%&%&%&%& %   %   %   $
     $       % &     % &/"/"/"/"% & % & % & % #
     #      &  %     & %&%&%&%&/& % & % & % & $
     $       % &     %        &"% & % & % & % #
     #       & %     &%&%&%&% %/& % & % & % & $
     $    &%&%  &    %        &"% & % & % & % #
     #         %     & %&%&%&%&/& % & % & % & $
     $  &%&%&%&%     % &/"/"/"/"%   %   %   % #
     #  %           %& %&%&%&%&%&%&%&%&%&%&%& $
     $  &           &   %                     #
     #  %           % / &                     $
     $  &           & " %                     #
     #  %&%&%&%&%&%&% / &                     $
     $                " %                     #
     #                  &                     $
     .a.a.a.a.a.a.a.a.a.a.a.a.a.a.a.a.a.a.a.a.a


[.]
nombre=carro
x=2
y=0
muro=1

[a]
nombre=carro
x=3
y=0
muro=1

[#]
nombre=barrVer
x=0
y=0
muro=1

[$]
nombre=barrVer2
x=1
y=0
muro=1

[%]
nombre=barrRoj
x=0
y=2
muro=1

[&]
nombre=barrRoj
x=1
y=2
muro=1

[/]
nombre=barrAzu
x=0
y=1
muro=1

["]
nombre=barrAzu2
x=1
y=1
muro=1

[ ]
nombre=espacio
x=2
y=1
muro=0
